# Android-specific keywords

# For an explanation of these tags, see Token.java 
# processing/app/src/processing/app/syntax/Token.java

VR	LITERAL2
AR	LITERAL2
STEREO	LITERAL2
MONO	LITERAL2
PORTRAIT	LITERAL2
LANDSCAPE	LITERAL2
displayDensity	KEYWORD4

orientation	FUNCTION1
hasPermission	FUNCTION1
requestPermission	FUNCTION1
touches	KEYWORD4
touchEnded	FUNCTION4
touchMoved	FUNCTION4
touchStarted	FUNCTION4
closeKeyboard	FUNCTION1
openKeyboard	FUNCTION1
wallpaperHomeCount	FUNCTION1
wallpaperOffset	FUNCTION1
wallpaperPreview	FUNCTION1
wearAmbient	FUNCTION1
wearBurnIn	FUNCTION1
wearInsets	FUNCTION1
wearInteractive	FUNCTION1
wearLowBit	FUNCTION1
wearRound	FUNCTION1
wearSquare	FUNCTION1
cameraUp	FUNCTION1
eye	FUNCTION1
getEyeMatrix	FUNCTION1
getObjectMatrix	FUNCTION1
getRayFromScreen	FUNCTION1
intersectsSphere	FUNCTION1
intersectsBox	FUNCTION1
intersectsPlane	FUNCTION1
calculate	FUNCTION1
push	FUNCTION1
pop	FUNCTION1
circle	FUNCTION1
square	FUNCTION1

VRCamera	KEYWORD5
ARTracker	KEYWORD5
ARTrackable	KEYWORD5
ARAnchor	KEYWORD5
